1111111111
1CCECCCCC1
1CCCCCCCC1
1CCCCCCCC1
1CCCCCPCC1
1CCCCCCCC1
1111111111
