11111111111111111111
1P000000111011000011
100111100B01C1101111
1101110001110C100011
11000B01111100111111
11110000B00000100001
11110010000110000111
1111000C00000B111111
11100B001110000000E1
11111111111111111111

