1111111111
1P00000001
1100000011
1100000011
1100000E11
1111111111