11111111111111111111
1P000000111010000011
100111100000CC101111
1101110001111C100011
11000001111100111111
11110000B00000100001
11110010000110000111
1111000C000000111111
11100B001110000000E1
11111111111111111111








