1111111111
1P00000001
11000C0011
1101110111
111000BE11
1111111111